{
  "start":
  {
    "level":  [
                [11, 11,  11,  11,  11, 11,  11,  11,  11, 11],
                [11,  7, 6, 6, 6, 6, 6, 9, 10,  10],
                [11,  4, 6, 6, 6, 6, 6, 9, 10,  10],
                [11,  4, 6, 6, 6, 6, 6, 9, 10,  8],
                [11,  9, 9, 6, 6, 4, 4,  9, 9,  11],
                [11,  9, 9, 6, 6, 4, 4, 4, 4,  11],
                [11,  10, 2, 6, 6, 4, 4, 4, 4,  11],
                [10,  10, 2, 2, 6, 6, 4, 4, 4,  11],
                [10,  10, 10, 2, 6, 6, 4, 4, 4,  11],
                [11,  11,  11,  11,  11,  11,  11,  11,  11, 11]
              ],

    "right": "room1",
    "up": "none",
    "down": "none",
    "left": "room2"
  },

  "room1":
  {
    "level":  [
                [11,  11,  11,  11,  11,  11,  11,  11,  11, 11],
                [6,   8, 2, 2, 4,  6, 2, 4, 4,  11],
                [6,  6, 2,  6, 4, 4, 4, 2, 4,  11],
                [11,  6, 4, 4, 4, 2, 4, 4, 2,  11],
                [11,  6, 4, 2, 2, 4, 2, 4, 8,  11],
                [11, 6, 4, 4, 6, 4, 4, 6, 4,  11],
                [11,  6, 4, 4, 6, 2, 6,  2, 6,  11],
                [11,  6, 4, 2,  6, 6,  6, 2, 6,  11],
                [11,  6, 4, 4,  6, 4,  6, 2, 6,  0],
                [11,  11,  11,  11,  11, 11,  11,  11,  11, 11]
              ],

    "up": "none",
    "right": "none",
    "down": "none",
    "left": "start"
  },

  "room2":
  {
    "level":  [
                [11,  11,  11,  11,  11,  11,  11,  11,  11, 11],
                [11,  2, 4, 4, 4, 4, 4, 4, 2,  11],
                [11,  4, 6, 6, 6, 6, 6, 4, 4,  11],
                [11,  4, 6, 4, 2, 4, 6, 4, 4,  11],
                [11,  4, 6, 2, 7, 2, 6, 4, 4,  11],
                [11,  4, 4, 4, 2, 4, 6, 4, 4, 11],
                [11,  4, 4, 4, 4, 4, 4, 4, 4,  11],
                [11,  4, 4, 4, 4, 4, 4, 4, 6,  6],
                [11,  2, 4, 4, 6, 6, 6, 6, 6,  6],
                [11,  11,  11,  11,  11,  11,  11,  11,  11, 11]
              ],

    "up": "none",
    "right": "start",
    "down": "none",
    "left": "none"
  }



}
